NO ./textures/north.xpm
SO ./textures/south.xpm
WE ./textures/west.xpm
EA ./textures/east.xpm

F 220,100,0
C 135,206,235

11111111111111111111
10000000001000000001
10111111101011111101
10100000001000000101
10101111111111110101
10100000000000010101
10111110111111010101
10000010100001010101
11111010101101010101
10000010101101000001
10111110101101111111
10100000101100000001
10101111101011111101
10101000001010000101
10101011111010110101
10001010000000110101
11110010111111110101
10000000100000000101
10111111101111111101
11111111111111111111
